111111111111111111111111111111111111111111111111111111111111111111111111111111111111111111111111111111111111
100000000000001100000010000000000000000000000000000000000000000000001110000000000000000000011111000000000001
100000000000001100000010000000000000000000000000000000000000000000001110000000000000000000011111000000000001
100000000000001100000010000000000000000000000000000000000000000000001110000000000000000000011111000000000001
100000000000001100000010000000000000000000000000000000000000000000001110000000000000000000011111011110111111
100000000000001100000011111111111111111111111011111111111111111111111110111111111111111111111111011000000011
100000000000001111101111111111111111111100000000000111111111110000000000111111111111111111111111011000000011
100000000000000000000000000000000001111100000000000111111111110111111111111111111111111111111111011111011111
101111111111111111111111111111111101111101111111110111111111110000000000000000000000000000000000011100000011
101111111111111100000000011111111100000000001110000000000000110111111111101111111111111111111111111100000011
100000000000001100000000011111111100000000001110000000000000110000000000101111111000001111000000001100000011
100000000000001100000000011111111111111111101111111110111111111111111111101000001000001111000000001111101111
100000000000001100000000011000000000000000001111111000000000000000000000001000001000000000000000000000000001
111111111111101100000000011000000000000000001111111000000000000000000000000000001000001111111011111100000001
100000000000001100000000000000000000000000001111111000000000000000000000001111111000001110000000001100000001
100000000000001111111111111000000000000000001111111000000000000000000000000000000000001110000000001100000001
111111111111111111111111111111111111111111111111111111111111111111111111111111111111111111111111111111111111